11111111111111
100000000000E1
1C00000P000001
11111111111111
